E..gggg...........
^====##=#=..^##^#.
^...........^..^#.
^..^===##########.
^..^..............
^..^.gg.....######
^.#####...........
^........######...
^.!.!.!..#....#...
^.!!!.!..#gggg#...
^.!.!.!..######..!
^$!.............^#