...gggg...........
^====##=#=..^##^#.
^...........^..^#.
^..^===##########.
^..^..............
^..^.gg.....######
^.#####...........
^........######...
^........#....#...
^........#gggg#...
^........######...
^$................