..................
^====##=#=..^##^#.
^...........^..^#.
^..^#############.
^..^..............
^..^........######
^.#####...........
^........######...
^........#....#...
^........#....#...
^........######...
^$................