............
^====##=#=..
^...........
^..^########
^..^........
^..^........
^.#####.....
^...........
^...........
^...........
^...........
^$..........